1111111111111111
1000000000000001
1000000000000001
1P000000C1000001
1000000000000001
1H00000000000001
1111111111111111