111111111111111111111111111
100000000000000000000000001
100000000C0C0000000000E0001
111111111111111111111111111