111111111111
10000000000001
111111111111