11111111111
10000000001
1P00000C001
100000E0001
11111111111
