1111111111
1P00000001
1111111101
1000000001
1011111111
1000000001
1011111111
1100000001
1E11111111
1111111111